


     
1111111111111111111111
10000011100BB000000101
10C0000000000000000101
10CC00001C100110000101 
10CC00001C00B11001E001
10CCBBBB1C00P11010C101
1111111111111111111111

       









	    
		 
		  
		   
		    